 //////////\\\\\\\\\
||/////////////////||                               
||/////////////////||
||/////////////////||
||/////////////////||
||/////////////////||
||/////////////////||
||\\\\\\\\\\\\\@@\\||
||\\\\\\\\\\\\\@@\\||
||\\\\\\\\\\\\\\\\\||
||\\\\\\\\\\\\\\\\\||
||\\\\\\\\\\\\\\\\\||
||\\\\\\\\\\\\\\\\\||
||\\\\\\\\\\\\\\\\\||

Puerta cerrada