###############################
#                          S  #
#                             #
#                             #
#           #                 #
#           #      @          #
#           #                 #
#     ################    Q   #
#P#                           #
###############################