###############################
#                          S  #
#                             #
#                             #
#            A     #          #
#                  #          #
#                  #          #
#  #####################      #
#                             #
###############################