###############################
#                    #P#   S  #
#                             #
#                             #
#            @     #          #
#                  #          #
#                  #          #
#  #####################      #
#                             #
###############################