###############################
#                   #P#       #
#  S         ?                #
#       ################      #
#           #                 #
#           #      @          #
#           #                 #
#                         Q   #
#                             #
###############################