###############################
#                   #P#       #
#  S    Ñ    ?                #
#       ################      #
#           #                 #
#           #                 #
#           #                 #
#                         Q   #
#                             #
###############################