###############################
#                    #A#   S  #
#                             #
#                             #
#                  #          #
#                  #          #
#                  #          #
#  #####################      #
#                             #
###############################