###############################
#                   #P#       #
#  ?         ?                #
#       ################      #
#           #                 #
#           #      @          #
#           #                 #
#                         ?   #
#                             #
###############################