###############################
#                          ?  #
#            ?                #
#                             #
#           #                 #
#           #      @          #
#           #                 #
#     ##################  ?   #
#P#                           #
###############################