############################################
#                                          #
#   ?    #                            ?    #
#        #                                 #
#        #              @                  #
#                                          #
#                                          #
#             # #                          #
#       ###########################        #
#                                          #
#                                     ?    #
#                                          #
############################################