##########
#A       #
#        #
#        #
##########