##########
#        #
#   A    #
#        #
##########